{
 "10396000": "DONO3",
 "12010000": "NASW1",
 "12013500": "WILW1",
 "12020000": "DOTW1",
 "12025000": "NEWW1",
 "12026150": "SKMW1",
 "12026400": "BCDW1",
 "12027500": "CGMW1",
 "12031000": "CRPW1",
 "12035000": "SATW1",
 "12037400": "MNSW1",
 "12043000": "CALW1",
 "12045500": "ELWW1",
 "12048000": "DRSW1",
 "12056500": "SKOW1",
 "12059500": "NSPW1",
 "12060500": "SSUW1",
 "12061500": "SRPW1",
 "12079000": "DSRW1",
 "12082500": "NISW1",
 "12089500": "MKNW1",
 "12093500": "ORTW1",
 "12094000": "FFXW1",
 "12095000": "SPEW1",
 "12100490": "WRAW1",
 "12101500": "PUYW1",
 "12113000": "AUBW1",
 "12117500": "LNDW1",
 "12119000": "RNTW1",
 "12121600": "ISSW1",
 "12134500": "GLBW1",
 "12138160": "SLTW1",
 "12141300": "TANW1",
 "12142000": "SNQW1",
 "12143400": "GARW1",
 "12144500": "SQUW1",
 "12148500": "TOLW1",
 "12149000": "CRNW1",
 "12150800": "MROW1",
 "12155300": "PILW1",
 "12155500": "SNAW1",
 "12167000": "ARGW1",
 "12175500": "THNW1",
 "12178000": "GORW1",
 "12181000": "SRMW1",
 "12186000": "WCHW1",
 "12189500": "SAKW1",
 "12193400": "SHAW1",
 "12194000": "CONW1",
 "12200500": "MVEW1",
 "12201500": "SMRW1",
 "12205000": "NFNW1",
 "12208000": "MFNW1",
 "12210000": "NSSW1",
 "12210700": "NRKW1",
 "12213100": "NKSW1",
 "12301933": "KBDM8",
 "12302055": "FISM8",
 "12304500": "TRYM8",
 "12305000": "LEOI1",
 "12306500": "EASI1",
 "12324200": "DLGM8",
 "12331800": "DRMM8",
 "12334510": "RCCM8",
 "12340000": "BONM8",
 "12340500": "ABOM8",
 "12342500": "WFBM8",
 "12344000": "DARM8",
 "12350250": "VICM8",
 "12354500": "SRGM8",
 "12355500": "FCFM8",
 "12358500": "WGCM8",
 "12362500": "SFCM8",
 "12363000": "CFMM8",
 "12365700": "SRLM8",
 "12366000": "WHRM8",
 "12370000": "SWRM8",
 "12372000": "FPOM8",
 "12388700": "PERM8",
 "12389000": "PLNM8",
 "12389500": "THRM8",
 "12390700": "PRCM8",
 "12395000": "PRTI1",
 "12401500": "FRYW1",
 "12404500": "LAUW1",
 "12409000": "KTFW1",
 "12411000": "PRCI1",
 "12413000": "ENVI1",
 "12414500": "CLDI1",
 "12414900": "SATI1",
 "12422500": "SPOW1",
 "12424000": "HAGW1",
 "12431000": "LSDW1",
 "12442500": "NITW1",
 "12445000": "TONW1",
 "12447200": "OKMW1",
 "12448500": "WTHW1",
 "12449950": "PATW1",
 "12451000": "STHW1",
 "12452000": "CHDW1",
 "12452800": "ARDW1",
 "12459000": "PESW1",
 "12472800": "PRDW1",
 "12484500": "UMTW1",
 "12510500": "KIOW1",
 "13010065": "FLGW4",
 "13011500": "PACW4",
 "13011900": "BFKW4",
 "13015000": "GVZW4",
 "13018750": "JKSW4",
 "13022500": "ALPW4",
 "13023000": "GREW4",
 "13027500": "SALW4",
 "13032500": "PALI1",
 "13037500": "HEII1",
 "13049500": "CHEI1",
 "13050500": "ANTI1",
 "13055000": "TEAI1",
 "13056500": "REXI1",
 "13057155": "SIFI1",
 "13058000": "RIRI1",
 "13060000": "SHYI1",
 "13062500": "SNAI1",
 "13069500": "BFTI1",
 "13073000": "TOPI1",
 "13077000": "AMFI1",
 "13105000": "SFLN2",
 "13120500": "HWRI1",
 "13127000": "MAKI1",
 "13142500": "BWMI1",
 "13148500": "WODI1",
 "13168500": "HOTI1",
 "13172500": "SWAI1",
 "13174000": "WDHN2",
 "13175100": "OMCN2",
 "13183000": "OWYO3",
 "13185000": "BTSI1",
 "13186000": "BRFI1",
 "13190500": "ANDI1",
 "13200000": "MORI1",
 "13206000": "BIGI1",
 "13215000": "WARO3",
 "13217500": "BEUO3",
 "13233300": "VALO3",
 "13235000": "PRLI1",
 "13236500": "DRBI1",
 "13247500": "HRSI1",
 "13251000": "PRPI1",
 "13258500": "CAMI1",
 "13266000": "WSRI1",
 "13290450": "HCDI1",
 "13309220": "MIDI1",
 "13316500": "RIGI1",
 "13317000": "WHBI1",
 "13333000": "TRYO3",
 "13334300": "ANAW1",
 "13336500": "SELI1",
 "13337000": "LOCI1",
 "13338500": "STII1",
 "13340000": "ORFI1",
 "13342500": "SPDI1",
 "13346800": "PACI1",
 "13348000": "PULW1",
 "13351000": "HOPW1",
 "14013000": "MLKW1",
 "14018500": "TCHW1",
 "14020000": "GIBO3",
 "14033500": "UMAO3",
 "14038530": "JHNO3",
 "14046000": "MONO3",
 "14046500": "SERO3",
 "14103000": "MODO3",
 "14113000": "PITW1",
 "14120000": "HODO3",
 "14137000": "SRMO3",
 "14142500": "SNDO3",
 "14152000": "JASO3",
 "14157500": "GOSO3",
 "14158050": "EUGO3",
 "14158850": "TRBO3",
 "14162500": "VIDO3",
 "14165000": "SPRO3",
 "14166000": "HARO3",
 "14170000": "MNRO3",
 "14171000": "PHIO3",
 "14174000": "ALBO3",
 "14183000": "MEHO3",
 "14187500": "WTLO3",
 "14188800": "TRSO3",
 "14189000": "JFFO3",
 "14190500": "SUVO3",
 "14191000": "SLMO3",
 "14194150": "MCMO3",
 "14200000": "CANO3",
 "14202000": "AURO3",
 "14203500": "DLLO3",
 "14207500": "WSLO3",
 "14207740": "OCUO3",
 "14209500": "TLYO3",
 "14210000": "ESTO3",
 "14211500": "SYCO3",
 "14226500": "PACW1",
 "14231000": "RAWW1",
 "14231900": "CIYW1",
 "14233500": "COKW1",
 "14236200": "TILW1",
 "14238000": "MAYW1",
 "14242580": "TOTW1",
 "14243000": "CASW1",
 "14299800": "VENO3",
 "14301000": "FSSO3",
 "14301500": "TLMO3",
 "14302480": "TRAO3",
 "14303600": "BEAO3",
 "14305500": "SILO3",
 "14306500": "TIDO3",
 "14307620": "MPLO3",
 "14308000": "TILO3",
 "14309000": "AZAO3",
 "14310000": "RDLO3",
 "14312000": "WSNO3",
 "14316700": "SCRO3",
 "14319500": "WNRO3",
 "14321000": "EKTO3",
 "14325000": "POWO3",
 "14326510": "MYPO3",
 "14327000": "MYNO3",
 "14327055": "COQO3",
 "14337500": "MLBO3",
 "14338000": "ELKO3",
 "14339000": "EGLO3",
 "14357500": "MFDO3",
 "14359000": "RYGO3",
 "14361500": "GRAO3",
 "14366000": "APRO3",
 "14369500": "ARWO3",
 "14372300": "AGNO3",
 "14377100": "KRBO3",
 "14400000": "CHTO3"
}